服务类别	服务	AWS	Google Cloud
计算	IaaS	Amazon Elastic Compute Cloud	Compute Engine
PaaS	AWS Elastic Beanstalk	App Engine
FaaS	AWS Lambda	Cloud Functions
容器	CaaS	Amazon Elastic Kubernetes Service、Amazon Elastic Container Service	Google Kubernetes Engine
没有基础架构的容器	AWS Fargate	Cloud Run
Container Registry	Amazon Elastic Container Registry	Container Registry
网络	虚拟网络	Amazon Virtual Private Cloud	Virtual Private Cloud
负载平衡器	Elastic Load Balancer	Cloud Load Balancing
专用互连连接	AWS Direct Connect	Cloud Interconnect
域名和 DNS	Amazon Route 53	Google Domains、Cloud DNS
CDN	Amazon CloudFront	Cloud CDN
DDoS 防火墙	AWS Shield、AWS WAF	Google Cloud Armor
存储	对象存储	Amazon Simple Storage Service	Cloud Storage
块存储	Amazon Elastic Block Store	永久性磁盘
低可用性存储	Amazon S3 标准 - 非频繁访问、Amazon S3 单区 – 非频繁访问	Cloud Storage Nearline 和 Cloud Storage Coldline
归档存储	Amazon Glacier	Cloud Storage Archive
文件存储	Amazon Elastic File System	Filestore
内存中数据存储	Azure Cache for Redis	Memorystore
数据库	RDBMS	Amazon Relational Database Service、Amazon Aurora	Cloud SQL、Cloud Spanner
NoSQL：键值对	Amazon DynamoDB	Firestore、Cloud Bigtable
NoSQL：已编入索引	Amazon SimpleDB	Firestore
内存中数据存储	Azure Cache for Redis	Memorystore
数据分析	数据仓库	Amazon Redshift	BigQuery
查询服务	Amazon Athena	BigQuery
消息传递	Amazon Simple Notification Service、Amazon Simple Queueing Service	Pub/Sub
批量数据处理	Amazon Elastic MapReduce、AWS Batch	Dataproc、Dataflow
流式数据处理	Amazon Kinesis	Dataflow
流式数据提取	Amazon Kinesis	Pub/Sub
工作流编排	Amazon Data Pipeline、AWS Glue	Cloud Composer
管理工具	部署	AWS CloudFormation	Cloud Deployment Manager
费用管理	AWS 预算	费用管理
操作	监控	Amazon CloudWatch	Cloud Monitoring
日志记录	Amazon CloudWatch Logs	Cloud Logging
审核日志记录	AWS CloudTrails	Cloud Audit Logs
调试	AWS X-Ray	Cloud Debugger
性能跟踪	AWS X-Ray	Cloud Trace
安全与身份	IAM	Amazon Identity and Access Management	Identity and Access Management
密钥管理	AWS Secrets Manager	Secret Manager
加密的密钥	AWS Key Management Service	Cloud Key Management Service
资源监控	AWS Config	Cloud Asset Inventory
漏洞扫描	Amazon Inspector	Web Security Scanner
威胁检测	Amazon GuardDuty	Event Threat Detection（Beta 版）
Microsoft Active Directory	AWS Directory Service	Managed Service for Microsoft Active Directory
机器学习	语音	Amazon Transcribe	语音转文字
视觉	Amazon Rekognition	Cloud Vision
自然语言处理	Amazon Comprehend	Cloud Natural Language API
翻译	Amazon Translate	Cloud Translation
对话界面	Amazon Lex	Dialogflow Enterprise Edition
Video Intelligence	Amazon Rekognition Video	Video Intelligence API
自动生成模型	Amazon SageMaker Autopilot	AutoML
全托管式机器学习	Amazon SageMaker	AI Platform
物联网	IoT 服务	Amazon IoT	Cloud IoT
